1111111111111111
10000P0CE0000001
1000000000000001
1000000000000001
1000000000000001
1000000000000001
1111111111111111