1111111111111111
10000P01E0000001
100C000110000001
10000001C1000001
1000100000000001
1000000000010001
1111111111111111