1111111111111111
10000PCE00000001
1111111111111111