11111111111111111111
10100000000C10000001
10100100001000001011
100000C1111100010001
100001000E00CPX01C01
10010000C00000100001
11111111111111111111