11111111111111111111
1P100000000C10000001
10100100001000001011
100000C1111100010001
100001000E00C0001C01
10010000C00000100001
111111111X1111111111