11111111111111111111
101X0C10000C10000001
10101110001000001011
100000C1111100010001
100001000E00CP001C01
10000000C00000100001
11111111111111111111