1111111111111
1C0100X0000C1
1000011111001
1P0000E000C01
1111111111111